{
    "map": [
        {"row": "1 1 1 1 1 1 1 1 1 1 1 1 1"},
        {"row": "1 2 2 2 2 2 2 2 2 2 2 2 1"},
        {"row": "1 2 1 1 1 1 1 1 1 1 1 2 1"},
        {"row": "1 2 1 1 1 0 1 0 1 1 1 2 1"},
        {"row": "1 2 1 1 1 0 1 0 1 1 1 2 1"},
        {"row": "1 2 1 0 1 1 1 1 1 0 1 2 1"},
        {"row": "1 2 1 1 0 0 0 0 0 1 1 2 1"},
        {"row": "1 2 1 1 1 1 1 1 1 1 1 2 1"},
        {"row": "1 2 2 2 2 2 2 2 2 2 2 2 1"},
        {"row": "1 1 1 1 1 1 1 1 1 1 1 1 1"},
        {"row": "0 0 0 0 0 0 0 0 0 0 0 0 0"},
        {"row": "0 0 0 0 0 0 0 0 0 0 0 0 0"},
        {"row": "0 0 0 0 0 0 0 0 0 0 0 0 0"}
    ]
}